NO ./textures/wall.xpm
SO ./textures/wall.xpm 
WE ./textures/wall.xpm 
EA ./textures/wall.xpm 
F 220,100,0
C 225,30,0
11111111111111111111111111111
10000000000000000000000000001
10000000000000000000000000001
10000000000000000000000000001
10000000000000N00000000000001
10000000000000000000000000001
10000000000000000000000000001
10000000000000000000000000001
11111111111111111111111111111
